culture	NOM	culture
cultures	NOM	culture
feuille	NOM	feuille
feuilles	NOM	feuille
plante	NOM	plante
plantes	NOM	plante
champ	NOM	champ
champs	NOM	champ
sec	ADJ	sec
secs	ADJ	sec
sèche	ADJ	sec
sèches	ADJ	sec
agronomique	ADJ	agronomique
grain	NOM	grain
grains	NOM	grain
eau	NOM	eau
eaux	NOM	eau
pousse	NOM	pousse
pousses	NOM	pousse
grande	ADJ	grand
grand	ADJ	grand
grandes	ADJ	grand
grands	ADJ	grand
plein	ADJ	plein
pleine	ADJ	plein
petit	ADJ	petit
petite	ADJ	petit
petites	ADJ	petit
petits	ADJ	petit
vert	ADJ	vert
verte	ADJ	vert
verts	ADJ	vert
vertes	ADJ	vert
